abundance: n.丰富;大量 (ab-:away + unda-:water, wave + -ance)
alleviate: vt.减轻,缓和  (al-,ad-,ac- + levi-: to raise, lift)
ambiguous: a.含糊不清的;引起歧义的  (ambi-: around,two + ig- = ag- : to drive, hence to go) +-uous
aviation: n.航空;飞行 (avi-, au-: bird + -ation)
coalition: n.结合,联合 (co- + ali-: to grow, nurture + -tion)
coincide: vi.同时发生,巧合;相符 (co-:together, with + in-:into + cid-: = cas-, cad- : to fall)
compatible: a.能共处的, 相容的;兼容的 (com-:with, together + pati-=pathi-,passi-: to feel,  suffer  v. 感觉;遭受;忍受)
complement: n./v. 补充物; 补充 (com- + plem-:full, fill 补充就是使其变满)
compulsory: a.义务的;强制的;必修的  (com- + pul-:to pull, push)
conscientious: a.认真的;凭良心做的; 勤勤恳恳的  (con- + scien-: to know)
conspicuous: (con-：全部，一起+ spic-,=spect-: see +-uous)
convict: vt.判…有罪    n. 囚犯 (con- + vict-: victory,win,conquer)
dedicate: vt.奉献;题献 (de-: down + dic-: say +-ate: 题献就是把要说的话写下来)
deliberate: a.深思熟虑的;故意的;  vi.仔细考虑 (de- + liber-:磅> weigh vt.权衡; 掂量 +-ate>
denounce: vt.谴责, 声讨 (de-:down + nounc-: say)
deprive: vt.剥夺;使丧失  (de-:away + priv-: private),
deviate: 背离，偏离 (de-:away + via-: way > 即离开正道)
diagnose: vt.诊断  (dia-:through + gno-=kno-: to know)
despise: vt.鄙视 (de-: down + spis-=spect-: see, look)
diffuse: v.扩散;传播; a.冗长的 (dif-:away + fus-: throw, cast,pour)
dilute: vt.稀释, （di-: away + lut-=lavi-: wash）
disperse: vt.驱散  vi.消散 (di-:away + spers-: sparse  a.稀疏的)
distort: vt.歪曲  (dis-:away + tort-: to twist扭、拧)
distract: vt.使分心,分散；消遣 (dis-:away + tract-: draw > see: abstract  n./a./v.摘要；抽象的；提取)
edible: a.可食的    n.食品，食物 （ed-= eat）
elapse: vi./n.(时间)消逝  (逝者如斯夫！) (e-:away + laps-: fall) With the elapse of time
eloquent: a.雄辩的,健谈的 (e-: out + loqu-: talk   健谈就是滔滔不绝地说)
envisage: vt.想像,设想；正视 (en- + vis-: see )
epidemic: a./n.流行病 (epi-: after + demi-: people   流行病就是跟在人群后)
equator: n.赤道,  (equa-: equal)
evacuate: vt.使疏散  (e-: out,away + vacu-: empty + -ate)
evoke: vt.唤起(记忆等),引起 (e- + vok-= voc-: voice)
exempt: a.被免除的  vt.免除 (ex-:out + empt-:take)
expedition: n.远征(队),考察队  (ex- + ped-: foot)
exquisite:a.精美的;精致的 （ex-: out + quisi-=quir-,quest-:  to ask, seek)
extinguish:vt.使熄灭  (ex-:out + sting  vt.刺；戳；叮)
extravagant: a.奢侈的;过度的 (extra-:too much + vag-: wander + -ant)
finite: a.有限的  (fin-:end, limit)
hierarchy: n.等级制度 (hier-: higher + -archy:统治)
homogeneous: a.同种类的,  (homo-: same + gen-:基因，人种，产生)
humid: a.潮湿的 (hum-: earth, ground)
hypothesis: n.前提, 假设 (hypo-: under + thesis: to put)
illusion: n.幻觉 il-:inner + lus-, lud-: play + -ion
impair: vt.损害;削弱 (im-: not + pair)
imperative: a.命令式的; 必要的;专横的;紧急的 ( from: emperor皇帝；帝王)
inaugurate: vt.为…举行就职典礼,使正式就任 (in-: into + augur  n.占卜师)
incentive: n.刺激,鼓励  (in-: inner+ cent-=canto, chant: to sing, say > 与charm有关)
incidence: n.发生，影响;发生率  (incident   n.) (in-: into + cid-> cas-, cad-: fall)
inertia: n.惰性,懒惰  (in-: not + ert-,art = erg-: work)
infectious: a.传染的；有感染力的  (in-: into + fect-: to do, make)
ingenious: a.足智多谋的,有独创性的；巧妙的 (in-: inner + genius)
inherent: a.固有的;内在的;与生俱来的 (in-: inner + her- = hesi-: cling, attach 粘，附)
innovation: n.革新,创新  (in- + nova-: new  使从里面变新)
inspiration: n.灵感;鼓舞人心的人(或物)  (in-: into + spir-: to breathe + -ation)
install: vt.安装  (in-: into + stall: stand 安装就是让...立在里面)
intact: a.未经触动的；完整无缺的 (in-：not  + tact-:= tag-, teg-, tig-, tang-:  touch)
intermittent: a.时断时续的，间歇的  (inter-: between + mit-: send + -ent)
intuition: n.直觉   (in-: inner, not + tut-+teach )
judicial: a.司法的 (judi- = jur-: law, just, judge,swear + -cial)
juvenile: a./n.青少年的 (juven- = young  > junior年少的 > senior年长的;高级的)
latitude: n.纬度 (lati-:side)
liability:  n.倾向(to);责任,义务;债务 (li-=ly-，lig-: to bind)
literacy: n.读写能力;知识  (liter- = letter：字母)
magnify: vt.扩大;夸大 (magni-: big + -fy: to make)
medieval: a.中世纪的  (medi-: middle + eva- = eve: time前夕; 傍晚)
monopoly: n.垄断；专卖（商品）(mono-: single + poly-: manage经营、管理)
mortal: a./n.会死的;致命的;凡人  (mort- : death，murder)
nil: n.零,无 nil = not, no 
nominate: vt.提名;任命  (nom-: name > anonymous匿名的, antonym 反义词)
obscure: a.黑暗的;模糊的;难理解的;无名的 (ob-: away + cure: to care照料;谨慎;忧虑)
oppress: vt.压迫;压制 op-: to + press: 压
patriot: n.爱国者 (patri-: father> fatherland  n. 祖国 > 父系社会对祖国的称呼)
plausible: a.貌似有理的;花言巧语的 (plaud-: 大的响声 > )
plight: n.困境, 窘境  (pli-, ply-,plex-,ploy-: fold, bend)
premature: a.早熟的;过早的  (mate   vi.交配 > 动物到了交配期就成熟了)
pretext: n.借口 (pre- +tect-: cover, weave)
prophet: n.预言家; 【宗】先知  (Mohamed)  (pro- +phet-: fess-, fam-, fab-:speak, talk)
radiant: a.光芒四射的;容光焕发的 （radi-：ray  n.光线 > X-ray)
reciprocal: a.相互的;互惠的 (reci-: back + pro-: before > forward and backward)
reconcile: vt.使和解;调解 (re-:back + concil-=council委员会, 理事会)
refuge: n.避难;收容所 fuge-:逃离 escape
renaissance: n.复活;文艺复兴 (re-:again + nais-:nat-: birth)
revive: v.使复苏;使恢复精力 (re-：back+ viv-: life)
sacred: a.神圣的 sacri-: 神的, 神圣的
saturate: vt.使饱和;浸透,使充满  (satis-: enough> asset
solicitor: n.恳求者;推销员; (soli-: 庄重的 + cit-: cite> shout, say)
subscribe: vi./vt.认捐; (在文件等下面)签字;预订;同意 (sub-:under + scirb-: write)
susceptible: a.易受…影响的;易被感动的 (sus-:under + cept-: ceive-: take, catch)
symmetry: n.对称,匀称 (sym-：same + meter：dimension，size，measure)
symposium: n.讨论会,座谈会;酒宴  (sym-：same + pos-: drink)
synthesis: n.综合; 合成 (syn-：same + thet-, thes-: put > thesis)
trivial:  a.琐细的 (tri-: three + via-:way > 正如一条大道分成三条则变得微不足道)
tuition: n.教诲;学费  (tuit: teach)
turbulent: a.汹涌的;骚动的;混乱的 (turb-: stir搅)
unanimous: a.全体一致的,一致同意的  (un- = uni-：one + anim-: mind, life)
validity: 有效性;合法性  (vali-, vail-：value,strong)
verdict: n.裁决,裁定; 判决 (ver-: true + dict-: say > 判决就是真实的说法)
vulnerable: a.易受伤的;易受攻击的源于vulture  n.秃鹰 > 秃鹰爪下的prey（猎物)